16 24
########################
#                      #
#                 #    #
#O   #                 #
#                #     #
#                      #
#                      #
#                      #
#                      #
#                      #
#                      #
#                      #
#                      #
#                      #
#                      #
########################

